###################
#........#........#
#.###.##.#.##.###.#
#*#.............#*#
#.###.#.###.#.###.#
#.....#..@..#.....#
#####.### ###.#####
#.......G.........#
#.###.#.###.#.###.#
#*....#.....#....*#
###################
